111111111
10PE10X01
100C1C001
111111111
