1111111111111
1000000010001
10PC000010001
100C010011111
100CE00001001
1000000001001
1111111111111