1111111111111
1000000010001
10PCE00010001
1000010011111
1000010000001
1000010000001
1111111111111
